版本号：1.0.0
维护者：smeiii
更新时间：2025-11-25
通用词条
Cloud Strife = 克劳德 斯特莱夫
Barret Wallace = 巴雷特 华莱士
Tifa Lockhart = 蒂法 洛克哈特
Aerith Gainsborough = 爱丽丝 盖恩斯巴勒
Biggs = 毕格斯
Wedge = 威吉
Jessie = 杰西
Marlene Wallace = 玛琳 华莱士
President Shinra = 神罗 总裁
Heidegger = 海德格
Scarlet = 史卡蕾特
Palmer = 帕尔默
Hojo = 宝条
Reeve Tuesti = 里维 图伊斯蒂
Rufus Shinra = 路法斯 神罗
Tseng = 曾
Reno = 雷诺
Rude = 路德
Elena = 伊莲娜
Sephiroth = 萨菲罗斯
Zack Fair = 扎克斯 菲尔
Angeal Hewley = 安吉尔 修雷
Genesis Rhapsodos = 杰尼西斯 拉普索道斯
Weiss = 魏斯
Nero = 尼禄
Kadaj = 卡丹裘
Yazoo = 亚祖
Loz = 洛兹
Yuffie Kisaragi = 尤菲 如月
Sonon = 索侬
Cait Sith = 凯特 西
Red XIII = 赤红十三
Vincent Valentine = 文森特 瓦伦丁
Cid Highwind = 希德 海温德
Shera = 谢拉
Jenova = 杰诺瓦
gold saucer = 金碟游乐场
Turks = 塔克斯
SOLDIER = 神罗特种兵
mako = 魔晄
midgar = 米德加
sector 7 slums = 第七区贫民窟
sector 5 slums = 第五区贫民窟
wall market = 围墙商店街
train graveyard = 列车墓地
church = 古教堂
shinra building = 神罗大厦
junon = 朱农
costa del sol = 太阳海岸
mt. corel = 科雷尔山
north corel = 北科雷尔
desert prison = 沙漠监狱
gongaga = 贡加加
cosmo canyon = 宇宙峡谷
nibelheim = 尼布尔海姆
mt. nibel = 尼布尔山
rocket town = 火箭村
temple of the ancients = 古代种神殿
forgotten capital = 忘却之都
great glacier = 大冰川
northern crater = 北方大空洞
edge = 边缘城
healin lodge = 赫兰疗养所
banora = 巴诺拉
banora village = 巴诺拉村
modeoheim = 莫迪欧海姆
modeo = 莫迪欧
buster sword = 毁灭剑
gatling gun = 加特林机枪
metal knuckles = 金属指虎
assault gun = 突击炮
hardedge = 破甲大剑
mythril saber = 秘银剑
pile bunker = 搏动炮
atomic scissors = 原子铁钳
princess guard = 公主守护
premium heart = 精品之心
missing score = 失落之数
death penalty = 死刑宣告
conformer = 村正
ultima weapon = 终极武器
materia blade = 魔晶石剑
master sword = 大师之剑
murasame = 村雨
yoshiyuki = 吉光
nail bat = 钉棒
tifa’s god’s hand = 上帝之手
vincent’s cerberus = 三头犬
cloud’s fusion swords = 六式
kadaj’s souba = 双破刃
yazoo’s velvet nightmare = 天鹅绒噩梦
sephiroth’s masamune = 正宗
chocobo = 陆行鸟
tiny bronco = 小野马飞机
buggy = 沙漠越野车
highwind = 海温德飞空艇
submarine = 潜水艇
shera = 雪菈号
rufus’s helicopter = 总统专用直升机
hardy-daytona = 哈雷-戴托纳
g-bike = 神罗摩托
restore = 恢复
fire = 火焰
ice = 冰雪
lightning = 闪电
wind = 风
earth = 大地
poison = 毒
time = 时间
gravity = 重力
barrier = 屏障
magnify = 扩大
ap = 范围化
elemental = 属性
combo = 连击
steal = 偷窃
enemy skill = 敌方招式
manipulate = 操控
deathblow = 致命一击
double cut = 二刀流
slash-all = 全体斩
flash = 闪光
mimic = 模仿
master magic = 魔晶石大师
master summon = 召唤大师
master command = 指令大师
summon = 召唤
choco/mog = 陆行鸟&莫古利
shiva = 希瓦
ifrit = 伊芙利特
ramuh = 拉姆
titan = 泰坦
odin = 奥丁
leviathan = 利维坦
bahamut = 巴哈姆特
kujata = 克贾达
alexander = 亚历山大
phoenix = 不死鸟
typoon = 堤丰
knights of the round = 圆桌骑士
G Sector = G 区
H Sector = H 区
Sector 0 = 第 0 区
Sector 4 Plate = 第四区圆盘
Sector 6 Slums = 第六区贫民窟
Loveless Avenue = 无爱大道
Shinra Warehouse = 神罗仓库
Shinra Training Facility = 神罗训练设施
Shinra Combat Simulator = 神罗战斗模拟室
Deepground Tunnels = 深层禁地通道
Banora Underground = 巴诺拉地下洞窟
Modeo Temple = 莫迪欧神殿
Cave of the Gi = 基之洞窟
Round Island = 圆形岛
Shinra Manor Basement = 神罗公馆地下室
Choco Bill’s Farm = 陆行鸟比尔农场
Mythril Mine = 秘银矿洞
Fort Condor Peak = 秃鹰堡垒山顶
North Corel Reactor Site = 北科雷尔反应堆旧址
Rocket Launch Pad = 火箭发射台
Edge Business District = 边缘城商务区
St. Ives Hospital = 圣伊夫医院
Healin Lodge Garage = 赫兰疗养所车库
Sector 7 Ruins = 第七区遗迹
Midgar Underground Network = 米德加地下管网
